1111111111111111111111111111110000
1000000000000000000000000000010000
1000000000000000000000000000010000
1112323231110011111111100111110000
1000001000000000001000000000010000
1000010000000000000100000000100000
1000100000000000000010000000010000
1000000000000000000001000000010000
1000000000000000000000100000010000
1000000000000000000000010000010000
1000000000000000000000001000010000
1000000000000000000000000100010000
1000000001111100000000000010010000
1000000001000100000000000000011111
1000000001000100000000000000010001
1000000000000000000000000000000001
1000000000000000000000000000010001
1000000000000000000000000000011111
1111111111111111111111111111110000
